//MAP CONVERTED BY dmm2tgm.py THIS HEADER COMMENT PREVENTS RECONVERSION, DO NOT REMOVE
"a" = (
/turf/closed/wall/mineral/titanium,
/area/shuttle/arrival)
"e" = (
/obj/structure/grille,
/obj/structure/window/shuttle,
/turf/open/floor/plating,
/area/shuttle/arrival)
"f" = (
/obj/structure/chair/comfy/shuttle{
	dir = 4
	},
/turf/open/floor/mineral/titanium/white,
/area/shuttle/arrival)
"h" = (
/turf/template_noop,
/area/space)
"i" = (
/obj/structure/window/shuttle,
/obj/structure/grille,
/turf/open/floor/plating,
/area/shuttle/arrival)
"k" = (
/obj/machinery/door/airlock/titanium,
/turf/open/floor/mineral/titanium/white,
/area/shuttle/arrival)
"q" = (
/obj/structure/table,
/obj/machinery/light,
/turf/open/floor/mineral/titanium/white,
/area/shuttle/arrival)
"x" = (
/obj/machinery/light{
	dir = 1
	},
/turf/open/floor/mineral/titanium/white,
/area/shuttle/arrival)
"A" = (
/obj/structure/shuttle/engine/heater{
	dir = 8
	},
/turf/open/floor/plating,
/area/shuttle/arrival)
"C" = (
/obj/structure/shuttle/engine/propulsion{
	dir = 8
	},
/turf/open/floor/plating,
/area/shuttle/arrival)
"D" = (
/obj/structure/chair/comfy/shuttle{
	dir = 1
	},
/turf/open/floor/mineral/titanium/white,
/area/shuttle/arrival)
"E" = (
/obj/structure/closet/firecloset/full,
/turf/open/floor/mineral/titanium/white,
/area/shuttle/arrival)
"F" = (
/obj/machinery/door/airlock/titanium,
/obj/docking_port/mobile/arrivals,
/turf/open/floor/mineral/titanium/white,
/area/shuttle/arrival)
"H" = (
/obj/structure/table,
/obj/machinery/light{
	dir = 1
	},
/turf/open/floor/mineral/titanium/white,
/area/shuttle/arrival)
"I" = (
/obj/machinery/light,
/turf/open/floor/mineral/titanium/white,
/area/shuttle/arrival)
"M" = (
/turf/open/floor/mineral/titanium/white,
/area/shuttle/arrival)
"Q" = (
/obj/structure/chair/comfy/shuttle{
	dir = 4
	},
/obj/effect/landmark/latejoin,
/turf/open/floor/mineral/titanium/white,
/area/shuttle/arrival)
"R" = (
/obj/structure/table,
/turf/open/floor/mineral/titanium/white,
/area/shuttle/arrival)
"S" = (
/obj/structure/chair/comfy/shuttle,
/turf/open/floor/mineral/titanium/white,
/area/shuttle/arrival)

(1,1,1) = {"
h
h
C
C
C
h
h
"}
(2,1,1) = {"
h
a
A
A
A
a
h
"}
(3,1,1) = {"
a
a
e
e
e
a
a
"}
(4,1,1) = {"
a
E
M
M
M
R
a
"}
(5,1,1) = {"
a
M
Q
Q
Q
R
a
"}
(6,1,1) = {"
a
x
M
M
M
I
a
"}
(7,1,1) = {"
F
M
Q
Q
Q
M
k
"}
(8,1,1) = {"
a
M
M
M
M
M
a
"}
(9,1,1) = {"
a
M
Q
Q
Q
M
a
"}
(10,1,1) = {"
a
M
M
M
M
M
a
"}
(11,1,1) = {"
a
x
Q
Q
Q
I
a
"}
(12,1,1) = {"
k
M
M
M
M
M
k
"}
(13,1,1) = {"
a
a
a
M
a
a
a
"}
(14,1,1) = {"
a
R
D
M
S
R
a
"}
(15,1,1) = {"
a
H
M
f
M
q
a
"}
(16,1,1) = {"
a
a
i
R
i
a
a
"}
(17,1,1) = {"
h
h
i
i
i
h
h
"}
